245	245	245	245	245	245	245	245	245	245	245	245	245	245	245	245	245	245	245	245	245	245	245	245	245	245	245	245	245	245	245	245	245	245	245	245	245	245	245	245	245	245	245	245	245	245	245	245	245	245	245	245	245	245	245	245	245	245	245	245	245	245	245	245	245	245	245	245	245	245	245	245	245	245	245	245	245	245	245	245	245	245	245	245	245	245	245	245	245	245	245	245	245	245	245	245	245	245	245	245	245	245	245	245	245	245	245	245	245	245	245	245	245	245	245	245	245	245	245	245	245	245	245	245	245	245	245	245	245	245	245	245	245	245	245	245	245	245	245	245	245	245	245	245	245	245	245	245	245	245	245	245	245	245	245	245	245	245	245	245	245	245	245	245	245	245	245	245	245	245	245	245	245	245	245	245	245	245	245	245
245	245	245	245	245	245	245	245	245	245	245	245	245	245	245	245	245	245	245	245	245	245	245	245	245	245	245	245	245	245	245	245	245	245	245	245	245	245	245	245	245	245	245	245	245	245	245	245	245	245	245	245	245	245	245	245	245	245	245	245	245	245	245	245	245	245	245	245	245	245	245	245	245	245	245	245	245	245	245	245	245	245	245	245	245	245	245	245	245	245	245	245	245	245	245	245	245	245	245	245	245	245	245	245	245	245	245	245	245	245	245	245	245	245	245	245	245	245	245	245	245	245	245	245	245	245	245	245	245	245	245	245	245	245	245	245	245	245	245	245	245	245	245	245	245	245	245	245	245	245	245	245	245	245	245	245	245	245	245	245	245	245	245	245	245	245	245	245	245	245	245	245	245	245	245	245	245	245	245	245
245	245	245	245	245	245	245	245	245	245	245	245	245	245	245	245	245	245	245	245	245	245	245	245	245	245	245	245	245	245	245	245	245	245	245	245	245	245	245	245	245	245	245	245	245	245	245	245	245	245	245	245	245	245	245	245	245	245	245	245	245	245	245	245	245	245	245	245	245	245	245	245	245	245	245	245	245	245	245	245	245	245	245	245	245	245	245	245	245	245	245	245	245	245	245	245	245	245	245	245	245	245	245	245	245	245	245	245	245	245	245	245	245	245	245	245	245	245	245	245	245	245	245	245	245	245	245	245	245	245	245	245	245	245	245	245	245	245	245	245	245	245	245	245	245	245	245	245	245	245	245	245	245	245	245	245	245	245	245	245	245	245	245	245	245	245	245	245	245	245	245	245	245	245	245	245	245	245	245	245
245	245	245	245	245	245	245	245	245	245	245	245	245	245	245	245	245	245	245	245	245	245	245	245	245	245	245	245	245	245	245	245	245	245	245	245	245	245	245	245	245	245	245	245	245	245	245	245	245	245	245	245	245	245	245	245	245	245	245	245	245	245	245	245	245	245	245	245	245	245	245	245	245	245	245	245	245	245	245	245	245	245	245	245	245	245	245	245	245	245	245	245	245	245	245	245	245	245	245	245	245	245	245	245	245	245	245	245	245	245	245	245	245	245	245	245	245	245	245	245	245	245	245	245	245	245	245	245	245	245	245	245	245	245	245	245	245	245	245	245	245	245	245	245	245	245	245	245	245	245	245	245	245	245	245	245	245	245	245	245	245	245	245	245	245	245	245	245	245	245	245	245	245	245	245	245	245	245	245	245
245	245	245	245	245	245	245	245	245	245	245	245	245	245	245	245	245	245	245	245	245	245	245	245	245	245	245	245	245	245	245	245	245	245	245	245	245	245	245	245	245	245	245	245	245	245	245	245	245	245	245	245	245	245	245	245	245	245	245	245	245	245	245	245	245	245	245	245	245	245	245	245	245	245	245	245	245	245	245	245	245	245	245	245	245	245	245	245	245	245	245	245	245	245	245	245	245	245	245	245	245	245	245	245	245	245	245	245	245	245	245	245	245	245	245	245	245	245	245	245	245	245	245	245	245	245	245	245	245	245	245	245	245	245	245	245	245	245	245	245	245	245	245	245	245	245	245	245	245	245	245	245	245	245	245	245	245	245	245	245	245	245	245	245	245	245	245	245	245	245	245	245	245	245	245	245	245	245	245	245
245	245	245	245	245	245	245	245	245	245	245	245	245	245	245	245	245	245	245	245	245	245	245	245	245	245	245	245	245	245	245	245	245	245	245	245	245	245	245	245	245	245	245	245	245	245	245	245	245	245	245	245	245	245	245	245	245	245	245	245	245	245	245	245	245	245	245	245	245	245	245	245	245	245	245	245	245	245	245	245	245	245	245	245	245	245	245	245	245	245	245	245	245	245	245	245	245	245	245	245	245	245	245	245	245	245	245	245	245	245	245	245	245	245	245	245	245	245	245	245	245	245	245	245	245	245	245	245	245	245	245	245	245	245	245	245	245	245	245	245	245	245	245	245	245	245	245	245	245	245	245	245	245	245	245	245	245	245	245	245	245	245	245	245	245	245	245	245	245	245	245	245	245	245	245	245	245	245	245	245
245	245	245	245	245	245	245	245	245	245	245	245	245	245	245	245	245	245	245	245	245	245	245	245	245	245	245	245	245	245	245	245	245	245	245	245	245	245	245	245	245	245	245	245	245	245	245	245	245	245	245	245	245	245	245	245	245	245	245	245	245	245	245	245	245	245	245	245	245	245	245	245	245	245	245	245	245	245	245	245	245	245	245	245	245	245	245	245	245	245	245	245	245	245	245	245	245	245	245	245	245	245	245	245	245	245	245	245	245	245	245	245	245	245	245	245	245	245	245	245	245	245	245	245	245	245	245	245	245	245	245	245	245	245	245	245	245	245	245	245	245	245	245	245	245	245	245	245	245	245	245	245	245	245	245	245	245	245	245	245	245	245	245	245	245	245	245	245	245	245	245	245	245	245	245	245	245	245	245	245
245	245	245	245	245	245	245	245	245	245	245	245	245	245	245	245	245	245	245	245	245	245	245	245	245	245	245	245	245	245	245	245	245	245	245	245	245	245	245	245	245	245	245	245	245	245	245	245	245	245	245	245	245	245	245	245	245	245	245	245	245	245	245	245	245	245	245	245	245	245	245	245	245	245	245	245	245	245	245	245	245	245	245	245	245	245	245	245	245	245	245	245	245	245	245	245	245	245	245	245	245	245	245	245	245	245	245	245	245	245	245	245	245	245	245	245	245	245	245	245	245	245	245	245	245	245	245	245	245	245	245	245	245	245	245	245	245	245	245	245	245	245	245	245	245	245	245	245	245	245	245	245	245	245	245	245	245	245	245	245	245	245	245	245	245	245	245	245	245	245	245	245	245	245	245	245	245	245	245	245
245	245	245	245	245	245	245	245	245	245	245	245	245	245	245	245	245	245	245	245	245	245	245	245	245	245	245	245	245	245	245	245	245	245	245	245	245	245	245	245	245	245	245	245	245	245	245	245	245	245	245	245	245	245	245	245	245	245	245	245	245	245	245	245	245	245	245	245	245	245	245	245	245	245	245	245	245	245	245	245	245	245	245	245	245	245	245	245	245	245	245	245	245	245	245	245	245	245	245	245	245	245	245	245	245	245	245	245	245	245	245	245	245	245	245	245	245	245	245	245	245	245	245	245	245	245	245	245	245	245	245	245	245	245	245	245	245	245	245	245	245	245	245	245	245	245	245	245	245	245	245	245	245	245	245	245	245	245	245	245	245	245	245	245	245	245	245	245	245	245	245	245	245	245	245	245	245	245	245	245
286	286	286	286	286	286	286	286	286	286	286	286	286	286	286	286	286	286	286	286	286	286	286	286	286	286	286	286	286	286	286	286	286	286	286	286	286	286	286	286	286	286	286	286	286	286	286	286	286	286	286	286	286	286	286	286	286	286	286	286	286	286	286	286	286	286	286	286	286	286	286	286	286	286	286	286	286	286	286	286	286	286	286	286	286	286	286	286	286	286	286	286	286	286	286	286	286	286	286	286	286	286	286	286	286	286	286	286	286	286	286	286	286	286	286	286	286	286	286	286	286	286	286	286	286	286	286	286	286	286	286	286	286	286	286	286	286	286	286	286	286	286	286	286	286	286	286	286	286	286	286	286	286	286	286	286	286	286	286	286	286	286	286	286	286	286	286	286	286	286	286	286	286	286	286	286	286	286	286	286
327	327	327	327	327	327	327	327	327	327	327	327	327	327	327	327	327	327	327	327	327	327	327	327	327	327	327	327	327	327	327	327	327	327	327	327	327	327	327	327	327	327	327	327	327	327	327	327	327	327	327	327	327	327	327	327	327	327	327	327	327	327	327	327	327	327	327	327	327	327	327	327	327	327	327	327	327	327	327	327	327	327	327	327	327	327	327	327	327	327	327	327	327	327	327	327	327	327	327	327	327	327	327	327	327	327	327	327	327	327	327	327	327	327	327	327	327	327	327	327	327	327	327	327	327	327	327	327	327	327	327	327	327	327	327	327	327	327	327	327	327	327	327	327	327	327	327	327	327	327	327	327	327	327	327	327	327	327	327	327	327	327	327	327	327	327	327	327	327	327	327	327	327	327	327	327	327	327	327	327
368	368	368	368	368	368	368	368	368	368	368	368	368	368	368	368	368	368	368	368	368	368	368	368	368	368	368	368	368	368	368	368	368	368	368	368	368	368	368	368	368	368	368	368	368	368	368	368	368	368	368	368	368	368	368	368	368	368	368	368	368	368	368	368	368	368	368	368	368	368	368	368	368	368	368	368	368	368	368	368	368	368	368	368	368	368	368	368	368	368	368	368	368	368	368	368	368	368	368	368	368	368	368	368	368	368	368	368	368	368	368	368	368	368	368	368	368	368	368	368	368	368	368	368	368	368	368	368	368	368	368	368	368	368	368	368	368	368	368	368	368	368	368	368	368	368	368	368	368	368	368	368	368	368	368	368	368	368	368	368	368	368	368	368	368	368	368	368	368	368	368	368	368	368	368	368	368	368	368	368
409	409	409	409	409	409	409	409	409	409	409	409	409	409	409	409	409	409	409	409	409	409	409	409	409	409	409	409	409	409	409	409	409	409	409	409	409	409	409	409	409	409	409	409	409	409	409	409	409	409	409	409	409	409	409	409	409	409	409	409	409	409	409	409	409	409	409	409	409	409	409	409	409	409	409	409	409	409	409	409	409	409	409	409	409	409	409	409	409	409	409	409	409	409	409	409	409	409	409	409	409	409	409	409	409	409	409	409	409	409	409	409	409	409	409	409	409	409	409	409	409	409	409	409	409	409	409	409	409	409	409	409	409	409	409	409	409	409	409	409	409	409	409	409	409	409	409	409	409	409	409	409	409	409	409	409	409	409	409	409	409	409	409	409	409	409	409	409	409	409	409	409	409	409	409	409	409	409	409	409
450	450	450	450	450	450	450	450	450	450	450	450	450	450	450	450	450	450	450	450	450	450	450	450	450	450	450	450	450	450	450	450	450	450	450	450	450	450	450	450	450	450	450	450	450	450	450	450	450	450	450	450	450	450	450	450	450	450	450	450	450	450	450	450	450	450	450	450	450	450	450	450	450	450	450	450	450	450	450	450	450	450	450	450	450	450	450	450	450	450	450	450	450	450	450	450	450	450	450	450	450	450	450	450	450	450	450	450	450	450	450	450	450	450	450	450	450	450	450	450	450	450	450	450	450	450	450	450	450	450	450	450	450	450	450	450	450	450	450	450	450	450	450	450	450	450	450	450	450	450	450	450	450	450	450	450	450	450	450	450	450	450	450	450	450	450	450	450	450	450	450	450	450	450	450	450	450	450	450	450
491	491	491	491	491	491	491	491	491	491	491	491	491	491	491	491	491	491	491	491	491	491	491	491	491	491	491	491	491	491	491	491	491	491	491	491	491	491	491	491	491	491	491	491	491	491	491	491	491	491	491	491	491	491	491	491	491	491	491	491	491	491	491	491	491	491	491	491	491	491	491	491	491	491	491	491	491	491	491	491	491	491	491	491	491	491	491	491	491	491	491	491	491	491	491	491	491	491	491	491	491	491	491	491	491	491	491	491	491	491	491	491	491	491	491	491	491	491	491	491	491	491	491	491	491	491	491	491	491	491	491	491	491	491	491	491	491	491	491	491	491	491	491	491	491	491	491	491	491	491	491	491	491	491	491	491	491	491	491	491	491	491	491	491	491	491	491	491	491	491	491	491	491	491	491	491	491	491	491	491
532	532	532	532	532	532	532	532	532	532	532	532	532	532	532	532	532	532	532	532	532	532	532	532	532	532	532	532	532	532	532	532	532	532	532	532	532	532	532	532	532	532	532	532	532	532	532	532	532	532	532	532	532	532	532	532	532	532	532	532	532	532	532	532	532	532	532	532	532	532	532	532	532	532	532	532	532	532	532	532	532	532	532	532	532	532	532	532	532	532	532	532	532	532	532	532	532	532	532	532	532	532	532	532	532	532	532	532	532	532	532	532	532	532	532	532	532	532	532	532	532	532	532	532	532	532	532	532	532	532	532	532	532	532	532	532	532	532	532	532	532	532	532	532	532	532	532	532	532	532	532	532	532	532	532	532	532	532	532	532	532	532	532	532	532	532	532	532	532	532	532	532	532	532	532	532	532	532	532	532
573	573	573	573	573	573	573	573	573	573	573	573	573	573	573	573	573	573	573	573	573	573	573	573	573	573	573	573	573	573	573	573	573	573	573	573	573	573	573	573	573	573	573	573	573	573	573	573	573	573	573	573	573	573	573	573	573	573	573	573	573	573	573	573	573	573	573	573	573	573	573	573	573	573	573	573	573	573	573	573	573	573	573	573	573	573	573	573	573	573	573	573	573	573	573	573	573	573	573	573	573	573	573	573	573	573	573	573	573	573	573	573	573	573	573	573	573	573	573	573	573	573	573	573	573	573	573	573	573	573	573	573	573	573	573	573	573	573	573	573	573	573	573	573	573	573	573	573	573	573	573	573	573	573	573	573	573	573	573	573	573	573	573	573	573	573	573	573	573	573	573	573	573	573	573	573	573	573	573	573
614	614	614	614	614	614	614	614	614	614	614	614	614	614	614	614	614	614	614	614	614	614	614	614	614	614	614	614	614	614	614	614	614	614	614	614	614	614	614	614	614	614	614	614	614	614	614	614	614	614	614	614	614	614	614	614	614	614	614	614	614	614	614	614	614	614	614	614	614	614	614	614	614	614	614	614	614	614	614	614	614	614	614	614	614	614	614	614	614	614	614	614	614	614	614	614	614	614	614	614	614	614	614	614	614	614	614	614	614	614	614	614	614	614	614	614	614	614	614	614	614	614	614	614	614	614	614	614	614	614	614	614	614	614	614	614	614	614	614	614	614	614	614	614	614	614	614	614	614	614	614	614	614	614	614	614	614	614	614	614	614	614	614	614	614	614	614	614	614	614	614	614	614	614	614	614	614	614	614	614
655	655	655	655	655	655	655	655	655	655	655	655	655	655	655	655	655	655	655	655	655	655	655	655	655	655	655	655	655	655	655	655	655	655	655	655	655	655	655	655	655	655	655	655	655	655	655	655	655	655	655	655	655	655	655	655	655	655	655	655	655	655	655	655	655	655	655	655	655	655	655	655	655	655	655	655	655	655	655	655	655	655	655	655	655	655	655	655	655	655	655	655	655	655	655	655	655	655	655	655	655	655	655	655	655	655	655	655	655	655	655	655	655	655	655	655	655	655	655	655	655	655	655	655	655	655	655	655	655	655	655	655	655	655	655	655	655	655	655	655	655	655	655	655	655	655	655	655	655	655	655	655	655	655	655	655	655	655	655	655	655	655	655	655	655	655	655	655	655	655	655	655	655	655	655	655	655	655	655	655
696	696	696	696	696	696	696	696	696	696	696	696	696	696	696	696	696	696	696	696	696	696	696	696	696	696	696	696	696	696	696	696	696	696	696	696	696	696	696	696	696	696	696	696	696	696	696	696	696	696	696	696	696	696	696	696	696	696	696	696	696	696	696	696	696	696	696	696	696	696	696	696	696	696	696	696	696	696	696	696	696	696	696	696	696	696	696	696	696	696	696	696	696	696	696	696	696	696	696	696	696	696	696	696	696	696	696	696	696	696	696	696	696	696	696	696	696	696	696	696	696	696	696	696	696	696	696	696	696	696	696	696	696	696	696	696	696	696	696	696	696	696	696	696	696	696	696	696	696	696	696	696	696	696	696	696	696	696	696	696	696	696	696	696	696	696	696	696	696	696	696	696	696	696	696	696	696	696	696	696
737	737	737	737	737	737	737	737	737	737	737	737	737	737	737	737	737	737	737	737	737	737	737	737	737	737	737	737	737	737	737	737	737	737	737	737	737	737	737	737	737	737	737	737	737	737	737	737	737	737	737	737	737	737	737	737	737	737	737	737	737	737	737	737	737	737	737	737	737	737	737	737	737	737	737	737	737	737	737	737	737	737	737	737	737	737	737	737	737	737	737	737	737	737	737	737	737	737	737	737	737	737	737	737	737	737	737	737	737	737	737	737	737	737	737	737	737	737	737	737	737	737	737	737	737	737	737	737	737	737	737	737	737	737	737	737	737	737	737	737	737	737	737	737	737	737	737	737	737	737	737	737	737	737	737	737	737	737	737	737	737	737	737	737	737	737	737	737	737	737	737	737	737	737	737	737	737	737	737	737
778	778	778	778	778	778	778	778	778	778	778	778	778	778	778	778	778	778	778	778	778	778	778	778	778	778	778	778	778	778	778	778	778	778	778	778	778	778	778	778	778	778	778	778	778	778	778	778	778	778	778	778	778	778	778	778	778	778	778	778	778	778	778	778	778	778	778	778	778	778	778	778	778	778	778	778	778	778	778	778	778	778	778	778	778	778	778	778	778	778	778	778	778	778	778	778	778	778	778	778	778	778	778	778	778	778	778	778	778	778	778	778	778	778	778	778	778	778	778	778	778	778	778	778	778	778	778	778	778	778	778	778	778	778	778	778	778	778	778	778	778	778	778	778	778	778	778	778	778	778	778	778	778	778	778	778	778	778	778	778	778	778	778	778	778	778	778	778	778	778	778	778	778	778	778	778	778	778	778	778
819	819	819	819	819	819	819	819	819	819	819	819	819	819	819	819	819	819	819	819	819	819	819	819	819	819	819	819	819	819	819	819	819	819	819	819	819	819	819	819	819	819	819	819	819	819	819	819	819	819	819	819	819	819	819	819	819	819	819	819	819	819	819	819	819	819	819	819	819	819	819	819	819	819	819	819	819	819	819	819	819	819	819	819	819	819	819	819	819	819	819	819	819	819	819	819	819	819	819	819	819	819	819	819	819	819	819	819	819	819	819	819	819	819	819	819	819	819	819	819	819	819	819	819	819	819	819	819	819	819	819	819	819	819	819	819	819	819	819	819	819	819	819	819	819	819	819	819	819	819	819	819	819	819	819	819	819	819	819	819	819	819	819	819	819	819	819	819	819	819	819	819	819	819	819	819	819	819	819	819
860	860	860	860	860	860	860	860	860	860	860	860	860	860	860	860	860	860	860	860	860	860	860	860	860	860	860	860	860	860	860	860	860	860	860	860	860	860	860	860	860	860	860	860	860	860	860	860	860	860	860	860	860	860	860	860	860	860	860	860	860	860	860	860	860	860	860	860	860	860	860	860	860	860	860	860	860	860	860	860	860	860	860	860	860	860	860	860	860	860	860	860	860	860	860	860	860	860	860	860	860	860	860	860	860	860	860	860	860	860	860	860	860	860	860	860	860	860	860	860	860	860	860	860	860	860	860	860	860	860	860	860	860	860	860	860	860	860	860	860	860	860	860	860	860	860	860	860	860	860	860	860	860	860	860	860	860	860	860	860	860	860	860	860	860	860	860	860	860	860	860	860	860	860	860	860	860	860	860	860
-1	-1	-1	-1	-1	-1	-1	-1	-1	-1	-1	-1	-1	-1	-1	-1	-1	-1	-1	-1	-1	-1	-1	-1	-1	-1	-1	-1	-1	-1	-1	-1	-1	-1	-1	-1	-1	-1	-1	-1	-1	-1	-1	-1	-1	-1	-1	-1	-1	-1	-1	-1	-1	-1	-1	-1	-1	-1	-1	-1	-1	-1	-1	-1	-1	-1	-1	-1	-1	-1	-1	-1	-1	-1	-1	-1	-1	-1	-1	-1	-1	-1	-1	-1	-1	-1	-1	-1	-1	-1	-1	-1	-1	-1	-1	-1	-1	-1	-1	-1	-1	-1	-1	-1	-1	-1	-1	-1	-1	-1	-1	-1	-1	-1	-1	-1	-1	-1	-1	-1	-1	-1	-1	-1	-1	-1	-1	-1	-1	-1	-1	-1	-1	-1	-1	-1	-1	-1	-1	-1	-1	-1	-1	-1	-1	-1	-1	-1	-1	-1	-1	-1	-1	-1	-1	-1	-1	-1	-1	-1	-1	-1	-1	-1	-1	-1	-1	-1	-1	-1	-1	-1	-1	-1	-1	-1	-1	-1	-1	-1
-1	-1	-1	-1	-1	-1	-1	-1	-1	-1	-1	-1	-1	-1	-1	-1	-1	-1	-1	-1	-1	-1	-1	-1	-1	-1	-1	-1	-1	-1	-1	-1	-1	-1	-1	-1	-1	-1	-1	-1	-1	-1	-1	-1	-1	-1	-1	-1	-1	-1	-1	-1	-1	-1	-1	-1	-1	-1	-1	-1	-1	-1	-1	-1	-1	-1	-1	-1	-1	-1	-1	-1	-1	-1	-1	-1	-1	-1	-1	-1	-1	-1	-1	-1	-1	-1	-1	-1	-1	-1	-1	-1	-1	-1	-1	-1	-1	-1	-1	-1	-1	-1	-1	-1	-1	-1	-1	-1	-1	-1	-1	-1	-1	-1	-1	-1	-1	-1	-1	-1	-1	-1	-1	-1	-1	-1	-1	-1	-1	-1	-1	-1	-1	-1	-1	-1	-1	-1	-1	-1	-1	-1	-1	-1	-1	-1	-1	-1	-1	-1	-1	-1	-1	-1	-1	-1	-1	-1	-1	-1	-1	-1	-1	-1	-1	-1	-1	-1	-1	-1	-1	-1	-1	-1	-1	-1	-1	-1	-1	-1
-1	-1	-1	-1	-1	-1	-1	-1	-1	-1	-1	-1	-1	-1	-1	-1	-1	-1	-1	-1	-1	-1	-1	-1	-1	-1	-1	-1	-1	-1	-1	-1	-1	-1	-1	-1	-1	-1	-1	-1	-1	-1	-1	-1	-1	-1	-1	-1	-1	-1	-1	-1	-1	-1	-1	-1	-1	-1	-1	-1	-1	-1	-1	-1	-1	-1	-1	-1	-1	-1	-1	-1	-1	-1	-1	-1	-1	-1	-1	-1	-1	-1	-1	-1	-1	-1	-1	-1	-1	-1	-1	-1	-1	-1	-1	-1	-1	-1	-1	-1	-1	-1	-1	-1	-1	-1	-1	-1	-1	-1	-1	-1	-1	-1	-1	-1	-1	-1	-1	-1	-1	-1	-1	-1	-1	-1	-1	-1	-1	-1	-1	-1	-1	-1	-1	-1	-1	-1	-1	-1	-1	-1	-1	-1	-1	-1	-1	-1	-1	-1	-1	-1	-1	-1	-1	-1	-1	-1	-1	-1	-1	-1	-1	-1	-1	-1	-1	-1	-1	-1	-1	-1	-1	-1	-1	-1	-1	-1	-1	-1
-1	-1	-1	-1	-1	-1	-1	-1	-1	-1	-1	-1	-1	-1	-1	-1	-1	-1	-1	-1	-1	-1	-1	-1	-1	-1	-1	-1	-1	-1	-1	-1	-1	-1	-1	-1	-1	-1	-1	-1	-1	-1	-1	-1	-1	-1	-1	-1	-1	-1	-1	-1	-1	-1	-1	-1	-1	-1	-1	-1	-1	-1	-1	-1	-1	-1	-1	-1	-1	-1	-1	-1	-1	-1	-1	-1	-1	-1	-1	-1	-1	-1	-1	-1	-1	-1	-1	-1	-1	-1	-1	-1	-1	-1	-1	-1	-1	-1	-1	-1	-1	-1	-1	-1	-1	-1	-1	-1	-1	-1	-1	-1	-1	-1	-1	-1	-1	-1	-1	-1	-1	-1	-1	-1	-1	-1	-1	-1	-1	-1	-1	-1	-1	-1	-1	-1	-1	-1	-1	-1	-1	-1	-1	-1	-1	-1	-1	-1	-1	-1	-1	-1	-1	-1	-1	-1	-1	-1	-1	-1	-1	-1	-1	-1	-1	-1	-1	-1	-1	-1	-1	-1	-1	-1	-1	-1	-1	-1	-1	-1
-1	-1	-1	-1	-1	-1	-1	-1	-1	-1	-1	-1	-1	-1	-1	-1	-1	-1	-1	-1	-1	-1	-1	-1	-1	-1	-1	-1	-1	-1	-1	-1	-1	-1	-1	-1	-1	-1	-1	-1	-1	-1	-1	-1	-1	-1	-1	-1	-1	-1	-1	-1	-1	-1	-1	-1	-1	-1	-1	-1	-1	-1	-1	-1	-1	-1	-1	-1	-1	-1	-1	-1	-1	-1	-1	-1	-1	-1	-1	-1	-1	-1	-1	-1	-1	-1	-1	-1	-1	-1	-1	-1	-1	-1	-1	-1	-1	-1	-1	-1	-1	-1	-1	-1	-1	-1	-1	-1	-1	-1	-1	-1	-1	-1	-1	-1	-1	-1	-1	-1	-1	-1	-1	-1	-1	-1	-1	-1	-1	-1	-1	-1	-1	-1	-1	-1	-1	-1	-1	-1	-1	-1	-1	-1	-1	-1	-1	-1	-1	-1	-1	-1	-1	-1	-1	-1	-1	-1	-1	-1	-1	-1	-1	-1	-1	-1	-1	-1	-1	-1	-1	-1	-1	-1	-1	-1	-1	-1	-1	-1
-1	-1	-1	-1	-1	-1	-1	-1	-1	-1	-1	-1	-1	-1	-1	-1	-1	-1	-1	-1	-1	-1	-1	-1	-1	-1	-1	-1	-1	-1	-1	-1	-1	-1	-1	-1	-1	-1	-1	-1	-1	-1	-1	-1	-1	-1	-1	-1	-1	-1	-1	-1	-1	-1	-1	-1	-1	-1	-1	-1	-1	-1	-1	-1	-1	-1	-1	-1	-1	-1	-1	-1	-1	-1	-1	-1	-1	-1	-1	-1	-1	-1	-1	-1	-1	-1	-1	-1	-1	-1	-1	-1	-1	-1	-1	-1	-1	-1	-1	-1	-1	-1	-1	-1	-1	-1	-1	-1	-1	-1	-1	-1	-1	-1	-1	-1	-1	-1	-1	-1	-1	-1	-1	-1	-1	-1	-1	-1	-1	-1	-1	-1	-1	-1	-1	-1	-1	-1	-1	-1	-1	-1	-1	-1	-1	-1	-1	-1	-1	-1	-1	-1	-1	-1	-1	-1	-1	-1	-1	-1	-1	-1	-1	-1	-1	-1	-1	-1	-1	-1	-1	-1	-1	-1	-1	-1	-1	-1	-1	-1
